1111111111111111111111111111111
1P10001010100000100000100000001
1011101010101111111011101111101
1010000010000000001C00000000101
1011101110111110111010101110111
1000000010101010001010101010101
1011101111101010111010101010101
10101000000000000C1010101000001
1010101111111110111010111110101
1010100010000000001010101000101
1110101111101110111110101111111
100000000010001010C000000010001
1011111010111011101010101110111
1000100010100010001010100000001
1110101011111111101110111011101
100010101000000C001010100010001
1111111010111111101010101110111
1000000000100010001000101000001
1111111110101010111011111111111
100000001010100C001010101000001
1111111011111011101110101010101
101000000000001C0000000010101E1
1010101011101111111111101111101
100010101000000C001010001010101
1011111011111111111010111010101
100C1C000C10001000100010101C001
1111111111101110111011101011101
100C000010101010000010000010101
1011101110101010101010101010101
1C1000000000000C101000101000001
1111111111111111111111111111111
