1111111111
1KKKKEKKK1
1CCCCC0CC1
100000C001
1000000001
1000100001
1000000001
1111011111
1111P11111
1111111111
