111111111111111
1CEKKKKCKKKKC01
1KCKKK00KKKK001
1KKCKKCKKCKKCK1
100000000000001
1C00000P00000C1
111111111111111
