11111111111111111
1E000000001C10101
10111110101010101
10001000100000001
11111111111011101
10000000100C10001
10111011111011111
101000100C0010001
10111011101010111
10100000101000101
111111101111101C1
1C001000100C00001
11101110101010111
1010100000101C1C1
1C101110111011101
100000000010000P1
11111111111111111
